{
    "name":"FLOOR_2",
    "map":[[1,1,1,1,1,1,1,1,1,1,1,1,1],
        [1,"downStair",0,0,0,0,0,"monster",0,0,0,0,1],
        [1,1,1,1,1,1,1,1,1,1,1,0,1],
        [1,0,0,0,0,0,0,0,0,0,1,0,1],
        [1,0,0,0,1,0,0,0,0,0,1,0,1],
        [1,1,0,1,1,0,0,0,0,0,1,0,1],
        [1,0,0,0,1,0,0,0,0,0,1,0,1],
        [1,0,0,0,1,0,0,0,0,0,1,0,1],
        [1,1,0,1,1,0,0,0,0,0,0,0,1],
        [1,0,0,0,1,1,0,1,1,1,0,1,1],
        [1,0,"monster",0,1,0,0,0,1,0,0,0,1],
        [1,0,0,0,1,0,0,0,1,0,0,0,1],
        [1,1,1,1,1,1,1,1,1,1,1,1,1]
    ]
}